{
  "Palette": "standard-cave.tile-palette.json",
  "Attributes": [ "map-part", "50x50" ],
  "Width":  50,
  "Height": 50,
  "Data": [
      [
         "xxxxxxxxxxxxxxxxxxxxxxxxxxxxxxxxxxxxxxxxxxxxxxxxxx",
         "x                                                x",
         "x                                                x",
         "x                                                x",
         "x                                                x",
         "x    xxxxxxxxxxxxxxxxxxxxxxxxxxxxxxxxxxxxxxx     x",
         "x    x.....................................x     x",
         "x    x.....................................x     x",
         "x    x.....................................x     x",
         "x    x.....................................x     x",
         "x    x.....................................x     x",
         "x    x.....................................x     x",
         "x    x.....................................x     x",
         "x    x.....................................x     x",
         "x    x.....................................x     x",
         "x    x.....................................x     x",
         "x    x.....................................x     x",
         "x    x.....................................x     x",
         "x    x.....................................x     x",
         "x    x.....................................x     x",
         "x    x.....................................x     x",
         "x    x.....................................x     x",
         "x    x.....................................x     x",
         "x    x.............sssssssssss.............x     x",
         "xxxxxx.............s.........s.............xxxxxxx",
         "........................^.........................",
         "...................s.........s....................",
         "xxxxxx.............sssssssssss.............xxxxxxx",
         "x    x.....................................x     x",
         "x    x.....................................x     x",
         "x    x.....................................x     x",
         "x    x.....................................x     x",
         "x    x.....................................x     x",
         "x    x.....................................x     x",
         "x    x.....................................x     x",
         "x    x.....................................x     x",
         "x    x.....................................x     x",
         "x    x.....................................x     x",
         "x    x.....................................x     x",
         "x    x.....................................x     x",
         "x    x.....................................x     x",
         "x    x.....................................x     x",
         "x    x.....................................x     x",
         "x    xxxxxxxxxxxxxxxxxxxxxxxxxxxxxxxxxxxxxxx     x",
         "x                                                x",
         "x                                                x",
         "x                                                x",
         "x                                                x",
         "x                                                x",
         "xxxxxxxxxxxxxxxxxxxxxxxxxxxxxxxxxxxxxxxxxxxxxxxxxx"
      ],
      [
         "xxxxxxxxxxxxxxxxxxxxxxxxxxxxxxxxxxxxxxxxxxxxxxxxxx",
         "x                                                x",
         "x                                                x",
         "x                                                x",
         "x                                                x",
         "x    xxxxxxxxxxxxxxxxxxxxxxxxxxxxxxxxxxxxxxx     x",
         "x    x.....................................x     x",
         "x    x.....................................x     x",
         "x    x.....................................x     x",
         "x    x.....................................x     x",
         "x    x.....................................x     x",
         "x    x.....................................x     x",
         "x    x.....................................x     x",
         "x    x.....................................x     x",
         "x    x.....................................x     x",
         "x    x.....................................x     x",
         "x    x.....................................x     x",
         "x    x.....................................x     x",
         "x    x.....................................x     x",
         "x    x.....................................x     x",
         "x    x.....................................x     x",
         "x    x.....................................x     x",
         "x    x.....................................x     x",
         "x    x.............sssssssssss.............x     x",
         "xxxxxx.............s.........s.............xxxxxxx",
         "........................v.........................",
         "...................s.........s....................",
         "xxxxxx.............sssssssssss.............xxxxxxx",
         "x    x.....................................x     x",
         "x    x.....................................x     x",
         "x    x.....................................x     x",
         "x    x.....................................x     x",
         "x    x.....................................x     x",
         "x    x.....................................x     x",
         "x    x.....................................x     x",
         "x    x.....................................x     x",
         "x    x.....................................x     x",
         "x    x.....................................x     x",
         "x    x.....................................x     x",
         "x    x.....................................x     x",
         "x    x.....................................x     x",
         "x    x.....................................x     x",
         "x    x.....................................x     x",
         "x    xxxxxxxxxxxxxxxxxxxxxxxxxxxxxxxxxxxxxxx     x",
         "x                                                x",
         "x                                                x",
         "x                                                x",
         "x                                                x",
         "x                                                x",
         "xxxxxxxxxxxxxxxxxxxxxxxxxxxxxxxxxxxxxxxxxxxxxxxxxx"
        ]
    ]
}
