{
  "attributes": [ "map-part", "50x50" ],
  "block-info": {
    "name": "test-block",
    "offset": { "x": 0, "y": 0 },
    "z":    1 
  },
  "width":  50,
  "height": 50,
  "routes": [
    {
      "file": "test2.json",
      "from": { "x": 25, "y": 25 },
      "to":   { "x": 25, "y": 25 }
    }
  ],
  "ascii": [
    "00000000000000000000000000000000000000000000000000",
    "00000000000000000000000000000000000000000000000000",
    "00000000000000000000000000000000000000000000000000",
    "00000000000000000000000000000000000000000000000000",
    "00000000000000000000000000000000000000000000000000",
    "00000xxxxxxxxxxxxxxxxxxxxxxxxxxxxxxxxxxxxxxx000000",
    "00000x                                     x000000",
    "00000x                                     x000000",
    "00000x                                     x000000",
    "00000x                                     x000000",
    "00000x                                     x000000",
    "00000x                                     x000000",
    "00000x                                     x000000",
    "00000x                                     x000000",
    "00000x                                     x000000",
    "00000x                                     x000000",
    "00000x                                     x000000",
    "00000x                                     x000000",
    "00000x                                     x000000",
    "00000x                                     x000000",
    "00000x                                     x000000",
    "00000x                                     x000000",
    "00000x                                     x000000",
    "00000x                                     x000000",
    "00000x                                     x000000",
    "00000x                 v                   x000000",
    "00000x                                     x000000",
    "00000x                                     x000000",
    "00000x                                     x000000",
    "00000x                                     x000000",
    "00000x                                     x000000",
    "00000x                                     x000000",
    "00000x                                     x000000",
    "00000x                                     x000000",
    "00000x                                     x000000",
    "00000x                                     x000000",
    "00000x                                     x000000",
    "00000x                                     x000000",
    "00000x                                     x000000",
    "00000x                                     x000000",
    "00000x                                     x000000",
    "00000x                                     x000000",
    "00000x                                     x000000",
    "00000xxxxxxxxxxxxxxxxxxxxxxxxxxxxxxxxxxxxxxx000000",
    "00000000000000000000000000000000000000000000000000",
    "00000000000000000000000000000000000000000000000000",
    "00000000000000000000000000000000000000000000000000",
    "00000000000000000000000000000000000000000000000000",
    "00000000000000000000000000000000000000000000000000",
    "00000000000000000000000000000000000000000000000000"
  ]
}
